111111111111111111111111111111111111111111
10C00C00010000C001C010C00000C0000000C001C1
11111C0001001111000111111C0001000111110001
1C00C10001C000C100000C00C10001C00000C10001
10C0110001111111000110C0110001111111110001
11000C001110C010000110000C001110C010000001
1000C0011P1000000C000C000100101000000C0001
111111C1100011000011111C110000001110000001
1100C0E00000C000C011100C00000C000C00000001
111000100100C1110011110001000C111111000001
1C0000100C00C0000C1C000100C00000C000000001
1111111C0100001100111111C01100000000011001
1C0000000000C0000C00C00C00000000C0000C00C1
1C00C0001011000C0C00100C00011C1CC0000C00C1
100000CC000000C0000C010C0C000000C0000C00C1
1000C000111C1110000C00C00C0C00C000000C00C1
1000C000111110000C00C00C000110C0C0C00C00C1
11110000C001110C01000000110C0110C010000001
100000000000C0000C00C00C0000000000C00C00C1
111111C110000001100001111111C1100001110001
111111111111111111111111111111111111111111
